%%%%%%%%%%%%%%%%%%%%
%o  .%  .    .%. o %
%.%%.%%%%%%%%.%.%% %
% %    .  %     .% %
%.%.%%.%% %%%.%%.%.%
% %    %  . %.  .  %
% %.%%%%%%% % %%.% %
% %. . %      ...%.%
% %% % %%%%%%%%.%% %
%  ..% . P    %  ..%
%%%%%%%%%%%%%%%%%%%%