%%%%%%%%%%%%%%%%%%
%o  .%  .    .%. %
%.%%.%%%%%%%%.%. %
% %    .         %
% %.%%%%% % % %% %
% %. . %      ...%
% %% % %%%%%%%%. %
%  ..% . P    % .%
%%%%%%%%%%%%%%%%%%